AmityvilleSD = County("Amityville School District", "NY", nbcRegion="newyork")
ArdsleySD = County("Ardsley School District", "NY", nbcRegion="newyork")
BaldwinPS = County("Baldwin Public Schools", "NY", nbcRegion="newyork")
BayShoreSD = County("Bay Shore School District", "NY", nbcRegion="newyork")
BedfordCentralSD = County("Bedford Central School District", "NY", nbcRegion="newyork")
BedminsterSD = County("Bedminster School District", "NJ", nbcRegion="newyork")
BellevillePS = County("Belleville School District", "NJ", nbcRegion="newyork")
BergenCTS = County("Bergen County Technical Schools", "NJ", nbcRegion="newyork")
BerkleyHeightsPS = County("Berkeley Heights Schools", "NJ", nbcRegion="newyork")
BernardsTownshipPS = County("Bernards Township Public Schools", "NJ", nbcRegion="newyork")
BloomfieldPS = County("Bloomfield Public School District", "NJ", nbcRegion="newyork")
BloomingdalePS = County("Bloomingdale School District", "NJ", nbcRegion="newyork")
BogotaPS = County("Bogota School District", "NJ", nbcRegion="newyork")

MontgomeryCPS = County("Montgomery County", "MD", "http://www.montgomeryschoolsmd.org/", "washington")
PrinceGeorgesCPS = County("Prince George's County", "MD", "http://www.pgcps.org/", "washington")
AnneArundelCPS = County("Anne Arundel County", "MD", "https://www.aacps.org/", "washington")
WinchesterPS = County("Winchester", "VA", nbcRegion="washington")
WashingtonCPS = County("Washington County", "MD", nbcRegion="washington")
WarrenCPS = County("Warren County", "VA", nbcRegion="washington")
StaffordCPS = County("Stafford County", "VA", nbcRegion="washington")
SpotsylvaniaCPS = County("Spotsylvania County", "VA", nbcRegion="washington")
PrinceWilliamCPS = County("Prince William County", "VA", nbcRegion="washington")
MorganCPS = County("Morgan County", "WV", nbcRegion="washington")
ManassasCityPS = County("Manassas City Schools", "VA", nbcRegion="washington")
ManassasParkCitySchools = County("Manassas Park City Schools", "VA", nbcRegion="washington")
LoudounCPS = County("Loudoun County Schools", "VA", nbcRegion="washington")
KingGeorgeCPS = County("King George County", "VA", nbcRegion="washington")
JeffersonCPS = County("Jefferson County Schools", "WV", nbcRegion="washington")
HowardCPS = County("Howard County Schools", "MD", nbcRegion="washington")
HardyCPS = County("Hardy County Schools", "WV", nbcRegion="washington")
HampshireCPS = County("Hampshire County Schools", "WV", nbcRegion="washington")
FredericksburgCPS = County("Fredericksburg Public Schools", "VA", nbcRegion="washington")
FrederickVACPS = County("Frederick County Schools (VA)", "VA", nbcRegion="washington")
FrederickMDCPS = County("Frederick County Schools (MD)", "MD", nbcRegion="washington")
FauquierCPS = County("Fauquier County Schools", "VA", nbcRegion="washington")
FallsChurchCPS = County("Falls Church Schools", "VA", nbcRegion="washington")
FairfaxCPS = County("Fairfax County Schools", "VA", nbcRegion="washington")
CulpeperCPS = County("Culpeper County Schools", "VA", nbcRegion="washington")
ClarkeCPS = County("Clarke County Schools", "VA", nbcRegion="washington")
CharlesCPS = County("Charles County Schools", "MD", nbcRegion="washington")
ColonialBeachPS = County("Colonial Beach Public Schools", "VA", nbcRegion="washington")
BerkeleyCPS = County("Berkeley County Schools", "WV", nbcRegion="washington")
ArlingtonCPS = County("Arlington County Schools", "VA", nbcRegion="washington")
AlexandriaCityPS = County("Alexandria Schools", "VA", nbcRegion="washington")

AndoverCPS = County("Andover Public Schools", "MA", nbcRegion="connecticut")
BozrahPS = County("Bozrah Public Schools", "CT", nbcRegion="connecticut")
ColchesterPS = County("Colchester Public Schools", "CT", nbcRegion="connecticut")
DanburyPS = County("Danbury Public Schools", "CT", nbcRegion="connecticut")
EastWindsorPS = County("East Windsor Public Schools", "CT", nbcRegion="connecticut")
EnfieldPS = County("Enfield Public Schools", "CT", nbcRegion="connecticut")
FranklinPS = County("Franklin Public Schools", "MA", nbcRegion="connecticut")
GrotonPS = County("Groton Public Schools", "CT", nbcRegion="connecticut")
HebronPS = County("Hebron Public Schools", "CT", nbcRegion="connecticut")
LebanonPS = County("Lebanon Public Schools", "CT", nbcRegion="connecticut")
LedyardPS = County("Ledyard Public Schools", "CT", nbcRegion="connecticut")
MarlboroughPS = County("Marlborough Public Schools", "MA", nbcRegion="connecticut")
NorthStoningtonPS = County("North Stonington Public", "CT", nbcRegion="connecticut")
Regional8 = County("Regional School District 8", "CT", nbcRegion="connecticut")
StoningtonPS = County("Stonington Public Schools", "CT", nbcRegion="connecticut")
SomersPS = County("Somers Public Schools", "CT", nbcRegion="connecticut")
WillingtonPS = County("Willington Public Schools", "CT", nbcRegion="connecticut")